|                 |
|  r              |
|                 |
|                 |
|###########      |
|                 |
|                 |
|                 |
|                 |
